11111
1PP01
11101
11001
11111

P
