11111
10001
1P001
10001
11111

P
