11111
10011
101P1
10001
11111

P
